ngocanh	cho	
kieulan	ahihi	
quynh	ahihi
quy	quy	
ma	ma	
hic	hic	
anh	a	
phuong	p	
love	l	
buingocphuong	p	
nguyetanh	anh	
only	o	
hu	hu	
nan	m	
hix	j	
vu	vu	
dat	dat	
ba	ba	
me	me	
con	con	
